Список команд
ls – відображає вміст директорії
pwd – показує активний каталог
clear – очищає екран терміналу
cd – змінює робочий каталог
pushd та popd – додає та видаляє каталогів із стека, pushd перемикає між двома верхніми каталогами стека
file – показує інформацію про файл
locate – шукає файли які є в базі даних, базу даних потрібно оновлювати з допомогою updatedb
find – шукає файли в системі
which – показує шлях до виконуваного бінарного файлу
history – показує історію виконаних команд
whatis – відображає короткий опис команд
apropos – шукає вказаний рядок у заголовках документації
man – друкує документацію
mkdir – створює директорії
touch – зміни дати та часу останнього редагування файлу
cp – копіює фали із точки переданої першим аргументом в точку передану другим аргументом
rmdir – видаляє порожні директорії
mv – переміщення файлі
rm – видалення файл
more та less – команди для перегляду файлів
nano – текстовий редактор
vim – потужний текстовий редактро із командним режимом
watch – команда яка запускає інші команди із певною періодичністю
free – деманструє кількість використаної оперативної памʼяті
df – показує кількість памʼяті на жорстких дисках
killall – команда для завершення всіх процеси за їхнім імʼям
sudo – запускає команди від іншого користувача
id – показує ID користувача та груп в яких знаходиться користувач
users – команда для перегляд списку користувачів

Перенаправлення виводу
> – перенаправлення потоку із перезаписом
>> – перенаправлення потоку із дозаписом
first | second – перенаправлення виводу першої команди